Age,Female,Male,Unknown,Total,
0,0,0,1,1,
1,29,46,10,85,
2,72,86,2,160,
3,45,52,1,98,
4,33,44,0,77,
5,38,32,0,70,
6,18,23,0,41,
7,12,25,0,37,
8,18,29,0,47,
9,13,31,0,44,
10,11,24,0,35,
11,14,25,0,39,
12,4,25,0,29,
13,9,17,0,26,
14,4,17,0,21,
15,3,15,0,18,
16,0,11,0,11,
17,4,8,0,12,
18,3,4,0,7,
19,6,7,0,13,
20,0,1,0,1,
21+,4,7,0,11,
22,1,1,0,2,
23,0,1,0,1,
24,0,1,0,1,
25,0,1,0,1,
26,0,2,0,2,
29,1,0,0,1,
